11111111111
1E000DD0011
11000000011
11D0CD00001
1P00CD00111
11111111111
