11111111111
1E000000011
11000000011
1100C000001
1P00C000111
11111111111
